20 20 20 20 20 20 20 20 20 20 20 20 20 20 20 20
03 03 03 03 03 03 03 03 03 03 03 03 03 03 03 03
03 03 03 03 03 03 03 03 03 03 03 03 03 03 03 03
12 12 12 12 12 12 12 12 12 12 12 12 12 12 12 12
05 05 05 05 05 05 05 05 05 05 05 05 05 05 05 05
07 07 07 07 07 07 07 07 07 07 07 07 07 07 07 07
24 24 24 24 24 24 24 24 24 24 24 24 24 24 24 24
21 21 21 21 21 21 21 21 21 21 21 21 21 21 21 21
29 29 29 29 29 29 29 29 29 29 29 29 29 29 29 29
03 03 03 03 03 03 03 03 03 03 03 03 03 03 03 03
03 03 03 03 03 03 03 03 03 03 03 03 03 03 03 03
03 03 03 03 03 03 03 03 03 03 03 03 03 03 03 03
03 03 03 03 03 03 03 03 03 03 03 03 03 03 03 03
03 03 03 03 03 03 03 03 03 03 03 03 03 03 03 03
03 03 03 03 03 03 03 03 03 03 03 03 03 03 03 03
03 03 03 03 03 03 03 03 03 03 03 03 03 03 03 03