20 20 20 20 20 20 20 20 20 20 20 20 20 20 20 20
20 03 03 03 03 03 03 03 03 03 03 03 03 03 03 03
20 03 03 03 03 03 03 03 03 03 03 03 03 03 03 03
20 03 03 14 12 12 12 12 12 12 12 12 12 12 12 12
20 03 03 10 05 05 05 05 05 05 05 05 05 05 05 05
20 03 03 10 05 06 07 07 07 07 07 07 07 07 07 07
20 03 03 10 05 09 23 24 24 24 24 24 24 24 24 24
20 03 03 10 05 09 26 21 21 21 21 21 21 21 21 21
20 03 03 10 05 09 28 29 29 29 29 29 29 29 29 29
12 12 12 13 05 11 12 12 12 12 12 15 03 03 03 03
05 05 05 05 05 05 05 05 05 05 05 09 03 03 03 03
07 07 07 07 07 07 07 07 07 07 07 17 03 03 03 03
20 03 03 03 03 03 03 03 03 03 03 03 03 03 03 03
20 03 03 03 03 03 03 03 03 03 03 03 03 03 03 03
20 03 03 03 03 03 03 03 03 03 03 03 03 03 03 03
20 03 03 03 03 03 03 03 03 03 03 03 03 03 03 03