20 20 20 20 20 20 20 20 20 20 20 20 20 20 20 20
20 3 3 3 3 3 3 3 3 3 3 3 3 3 3 3
20 3 3 3 3 3 3 3 3 3 3 3 3 3 3 3
20 3 3 14 12 12 12 12 12 12 12 12 12 12 12 12
20 3 3 10 5 5 5 5 5 5 5 5 5 5 5 5
20 3 3 10 5 6 7 7 7 7 7 7 7 7 7 7
20 3 3 10 5 9 23 24 24 24 24 24 24 24 24 24
20 3 3 10 5 9 26 21 21 21 21 21 21 21 21 21
20 3 3 10 5 9 28 29 29 29 29 29 29 29 29 29
12 12 12 13 5 11 12 12 12 12 12 15 3 3 3 3
5 5 5 5 5 5 5 5 5 5 5 9 3 3 3 3
7 7 7 7 7 7 7 7 7 7 7 17 3 3 3 3
20 3 3 3 3 3 3 3 3 3 3 3 3 3 3 3
20 3 3 3 3 3 3 3 3 3 3 3 3 3 3 3
20 3 3 3 3 3 3 3 3 3 3 3 3 3 3 3
20 3 3 3 3 3 3 3 3 3 3 3 3 3 3 3